1111111111111111
1000000000000001
1000000000000001
1000000000000001
1000000000000001
1000000000000001
1000000000000001
1000000000000001
1111111111111111
1111114006001111
1111111111151111
1000000000050001
1000000000050001
1200003000050001
1111111011111111
1111111111111111