1111111111111111
1000000000000001
1000000000000001
1000000000000001
1000000000000001
1000000000000001
1000000000300001
1000000000300001
1000000000115111
1000000000405001
1000000000105001
1000000000005001
1000040006005001
1200030000005001
1111110111111111
1111111111111111