1111111111111111
1000000000000001
1000000000000001
1000000000000001
1000000000000001
1000000000000001
1000000000000001
1400000003000021
1111111101111511
1400000030000501
1111111011111511
1400000300000501
1111110111111511
1400003000000501
1111101111111111
1111111111111111