1111111111111111
1000000000000001
1000000000000001
1000000000000001
1000000000000001
1000000000000001
1000000000000001
1003000030300001
1555556555555551
1111110000000051
1000000000000051
1000000400000051
1000010111111151
1000010000000051
1040010200000051
1111111111111111