1111111111111111
1000000000000001
1000000000000001
1000000000011151
1000003003000051
1000306004000051
1001111111100051
1000000000000051
1000000000000051
1020000000000051
1111111111100051
1000000000000051
1000000000400051
1000000000600051
1000000000400051
1111111111111111